?AAAAAAAAAAAAAAA
?AAAAAAAAAAAAAAA
?AAAAAAAAAAAAAAA
?AAAAAAAAAAAAAAA
?AP! AAAAAE    A
?A!!1AAAAA 1  4A
?A!!EAAAAA   Y A
?AAAAAAAAA     A
?AAAAAAAAAAAAAAA
?AAAAAAAAAAAAAAA
?AAAAAAAAAAAAAAA
?AAAAAAAAAAAAAAA